4 5
#########
#.......#
#.......#
#c.p.c..#
#.......#
#..p....#
#########

