4 5
#########
#a.....c#
#.......#
#a.a....#
#.......#
#p.....o#
#########