4 5
#########
#..v.p.p#
#.......#
#c...v..#
#.......#
#..c....#
#########