4 5
#########
#..o.a..#
#.......#
#a.a.p.v#
#.......#
#.......#
#########