4 5
#########
#.......#
#.......#
#c.p.v.v#
#.......#
#c.p.o.o#
#########