4 5
#########
#a...p..#
#.......#
#..o...a#
#.......#
#a...c..#
#########