4 5
#########
#a.p.a.a#
#.......#
#.......#
#.......#
#v.c....#
#########