4 5
#########
#..a...o#
#.......#
#..a....#
#.......#
#p...c.a#
#########