4 5
#########
#a.....a#
#.......#
#c.p...a#
#.......#
#......o#
#########