4 5
#########
#....v.v#
#.......#
#....p.o#
#.......#
#c.c.p.o#
#########