4 5
#########
#.......#
#.......#
#v.....v#
#.......#
#o.....o#
#########