4 5
#########
#p.c....#
#.......#
#....c..#
#.......#
#......p#
#########
