4 5
#########
#c.v...p#
#.......#
#c.....p#
#.......#
#o.o.v..#
#########