4 5
#########
#p.p.c.c#
#.......#
#v.....o#
#.......#
#v.....o#
#########