4 5
#########
#.......#
#.......#
#a......#
#.......#
#a...p.c#
#########