4 5
#########
#..c...v#
#.......#
#....o..#
#.......#
#..a.a.a#
#########