4 5
#########
#o.p.a.a#
#.......#
#.......#
#.......#
#.......#
#########