4 5
#########
#....o.a#
#.......#
#....v..#
#.......#
#a.a.p..#
#########