4 5
#########
#o.c...p#
#.......#
#....p..#
#.......#
#o.c....#
#########