4 5
#########
#....p.a#
#.......#
#o.....a#
#.......#
#a.c....#
#########