4 5
#########
#......v#
#.......#
#..o.o.p#
#.......#
#v.....p#
#########