4 5
#########
#o.v....#
#.......#
#.......#
#.......#
#..a.a..#
#########