4 5
#########
#..a.p.a#
#.......#
#....a.o#
#.......#
#......c#
#########