4 5
#########
#c.o.o.p#
#.......#
#.......#
#.......#
#....c.p#
#########