4 5
#########
#..v...a#
#.......#
#..o....#
#.......#
#..a.a.c#
#########