4 5
#########
#o......#
#.......#
#v.o...c#
#.......#
#..v...c#
#########