4 5
#########
#o.o....#
#.......#
#..p.v..#
#.......#
#p.....v#
#########