4 5
#########
#c...o.o#
#.......#
#....c.p#
#.......#
#v.v...p#
#########