4 5
#########
#....c..#
#.......#
#p.p...c#
#.......#
#v.....v#
#########