4 5
#########
#......v#
#.......#
#v.p...p#
#.......#
#..c...c#
#########