4 5
#########
#a......#
#.......#
#..o.a..#
#.......#
#..c.a.v#
#########